bạk: bạch
bưc: bức
bùl: buồn
nếnh: nến
byt: buýt
cak: cách
cẻ: kẻ
cik: kinh
oxi: ô xi
oxy: ô xi
axit: a xít
cín: kín
cìw: kiều
côt: cốt
cũg: cũng
dáh: đánh
dấy: đấy
dìw: điều
dồ: đồ
dôg: đông
dọg: đọng
dớn: đớn
dừz: đường
fẳg: phẳng
fải: phải
fân: phân
fố: phố
fog: phong
fưz: phương
fựz: phượng
ge: ghe
gế: ghế
gen: ghen
hồg: hồng
ja: gia
já: giá
jà: già
jấy: giấy
jì: gì
jìn: gìn
jờ: giờ
jở: giở
jòg: giòng
jù: dù
jữ: giữ
kăn: khăn
ken: khen
ki: khi
kó: khó
kôg: không
lặg: lặng
lòg: lòng
lỵ: luỵ
mệh: mệnh
mih: minh
mừi: mười
mul: muôn
net: nét
nge: nghe
ngề: nghề
ngĩ: nghĩ
ngil: nghiên
h’leo: hờ leo
ea: e a
ngòj: ngoài
ngọj: ngoại
ngừj: người
nhiw: nhiêu
nhưg: nhưng
nhữg: những
nup: núp
ôg: ông
qa: qua
qan: quan
qay: quay
qen: quen
qên: quên
qệt: quyệt
qý: quý
rồg: rồng
tăc: tắc
tak: tách
thừz: thường
thý: thuý
tih: tinh
tìh: tình
tĩh: tĩnh
trìw: triều
trog: trong
trồg: trồng
trug: trung
trưs: trước
trỳl: truyền
tyd: tuyết
vàg: vàng
vắg: vắng
vid: viết
vil: viên
vữg: vững
vưz: vương
xah: xanh
zâu: dâu
zì: dì
zo: do
zự: dự
roy: rồi
oh: ồ
ko: không
k: không
trc: trước
bít: biết
fb: facebook
chứt: chức
khmer: khờ me
brâu: bờ râu
bru: bờ ru
kor: co
hrê: hờ rê
mnông: mờ nông
xtiêng: ti en
hmong: hờ mông
péo: béo
rhadé: ra dé
raglai: ra lai
raglei: ra lây
noang: non
laoang: lao ang
paleng: ba len
xơlang: sơ lang
toong: tông
pọng: bọng
glơ: lơ
lar: la
plây: bờ lây
pleiku: bờ lây cu
yang: giang
thưr: thư
thớp: thớt
yung: giun
blui: bờ lui
blinh: bờ linh
nhiêng: nhiên
đim: dim
đech: đếch
tôc: tóc
brạo: bờ rạo
kontum: con tum
srúc: sờ rúc
cùa: cùa
chro: chờ ro
chrau: chờ rau
bicu: bi cu
sree: sờ re
bondưng: bon dưng
đazur: đa giu
đakriêng: đa riêng
đưngur: đư gu
kơ: cơ
kdun: cờ du
kơpa: cơ ba
kơsa: cơ sa
kra: cờ ra
zanh: gianh
ktol: cờ to
liênghót: liêng hót
paungtin: bau tin
rglê: rờ lê
rơô: rơ ô
rơon: rơ on
sarem: sa rem
sơao: sơ ao
srê: sờ rê
lơmu: lơ mu
kroong: cờ rong
tuprông: tu rông
nim: nim
mơlam: mơ lam
achuếch: a chết
adốt: a dốt
nđnok: đờ nóc
prông: bờ rong
proong: bờ rong
bluông: bờ luông
bruốt: bờ ruốc
đuốt: đuốc
kriêng: cờ riêng
bloong: bờ lông
choong: chông
unh: ừ
plei: bờ lây
pooc: bốc
lêp: lép
hnei: hờ nây
ah: a
kúm: cúm
kmụ: cờ mụ
rvai: rờ vai
veng: ven
lắk: lắc
tlắp: tờ lắp
đêr: đê
tmoong: tờ mông
tiác: ti ác
goi: goi
oivê: ô vê
mar: ma
kưmbur: cơ bu
thràng: tờ ràng
tgooc: tờ gốc
xlooc: sờ lóc
tlê: tờ lê
chưnđre: chưng re
tloc: tờ lóc
klảng: cờ lãng
glava: la va
tvạ: tờ vạ
tờrông: tờ rông
blai: bờ lai
niễu: niễu
soong: song
lip: líp
ôc: ốc
tlăp: tờ lắp
krlự: cờ lự
đnẹ: đờ nẹ
blao: bờ lao
sôp: sốp
huây: hay
kva: cờ va
kbình: cờ bình
hmông: hờ mông
gioảng: gioảng
chìn: chình
nệnh: nện
lot: lót
pàn: bàn
kây: cây
gar: ga
kuyênh: khuy en
prong: bờ rông
riăm: ri am
dak: đắc
pnông: bờ nông
lak: lắc
sưr: sư
tg: tác giả
bing: binh
busor: bu so
đôp: đốp
krong: cờ rong
đrang: đờ rang
lieng: li en
hot: hót
đing: đinh
lưk: lư
mbuôn: mờ buôn
mđrang: mờ rang
mok: móc
nđu: nờ đu
ntor: nờ to
pang: bang
pé: bé
sur: su
ting: tinh
tsong: tờ song
mbre: mờ re
phok: phóc
rche: rờ che
rchil: rờ chiêu
lăk: lắc
sruk: sờ ru
tơr: tơ
triek: trét
vmăk: vờ mắc
ntor: nờ to
pột: bột
kêr: kê
hăr: ha
plup: lu
khạ: cạ
chại: chạy
poọng: bọng
kxing: cờ xinh
đrá: ra
kmang: cờ mang
zàng: giàng
vủ: vũ
pầu: bầu
pu: bu
sủn: sủng
hua: hua
sli: sờ li
pờ: bờ
sèn: xèn
dín: dính
slử: sờ lử
slay: sờ lây
phén: phéng
tẻn: tẽn
mùn: mùng
mán: máng
lya: li a
pạ: bạ
paseng: ba sen
pế: bế
sìn: xìn
pún: bún
chéng: chén
zhang: giang
déo: déo
đện: điện
lăp: lắp
cru: cờ ru
cado: ca do
kôt: cốt
bnahria: bờ na ri a
lơng: lơn
kbao: cờ bao
mhơi: mờ hơi
rchom: rờ chôm
rsiu: rờ siu
rmah: rờ ma
ksor: cờ so
rahlan: ra lan
hieo: hi eo
kpă: cờ pa
kbla: cờ la
ksơr: cờ sơ
kreng: cờ reng
bobo: bo bo
pupo: bu bo
kazá: ca giá
camau: ca mau
chama: cha ma
chip: chíp
catơ: ca tơ
anu: a nu
xeng: xen
séng: xén
saư: sa ư
chom: chôm
dẹ: de
pươi: bươi
lok-ly: lo ly
pá: bá
duyền: duyên
pâu: bâu
páo: báo
pố: bố
dửn: dửng
nìu: nhìu
nghiã: nghĩa
cởng: cỡn
băc: bắc
đăt: đắc
tich: tích
viêt: viết
thưở: thuở
lich: lít
niê: ni ê
kđăm: cờ đăm
hhen: hờ hen
hoà: hòa
rađe: ra đe
krung: cờ run
ktul: cờ tu
đlie: đờ li ê
epan: ê ban
êđê: ê đê
thày: thầy
yàng: giàng
choá: cho á
gah: ga
êđe: ê đê
mớí: mới
adrâng: a rân
ayun: a un
tul: tu
atul: a tu
buon: buôn
yah: da
duot: dượt
eban: ê ban
rah: ra
eman: ê man
emo: ê mo
enoul: ê no
hđok: hờ đo
hrue: hờ ru
hmok: hờ móc
jdrong: dờ rong
ktub: cờ tu
knul: cờ nu
kpor: cờ bo
ktla: cờ ta la
mjao: mi ao
mlo: mờ lo
duon: dương
hut: hút
ksei: cờ xây
nie: ni ê
blo: bờ lo
dap: dáp
rit: rít
mla: mờ la
sieng: si yên
sor: so
sok: sóc
hlinh: hờ linh
palei: ba lây
samách: sa mách
maha: ma ha
rudra: ru ra
inra: in ra
patra: pa tra
inđra: in ra
sara: sa ra
cri: cờ ri
lờy: lời
lỗu: lỗ
đựoc: được
klăn: cờ lăn
thăk: thắc
thak: then
eli: e li
đwai: đờ quai
lòai: loài
won: quan
kut: cút
pui: bui
đắk: đắc
đăk: đắc
ali: a li
mousa: mô sa
ysa: i sa
nguỵ: ngụy
uc: úc
xoè: xòe
pặp: bặp
khun: cờ hun
khuống: cờ huống
khằm: cờ hằm
lềm: lềnh
phia: khuya
tuỳ: tùy
cu-mưng: cu mưng
phìâ: phì
thuỷ: thủy
hoóng: hóng
lọai: loại
jan: gian
tuúp: túp
nưóc: nước
noóc: nóc
roong: rong
đăc: đắc
đuổng: đuông
thằm: thằm
nhâp: nhấp
nủ: nhủ
pú: bú
sếnh: sến
đựơc: được
krom: cờ rom
khêmara: khê ma ra
phum: phun
sampôt: sam bốt
khrâm: khờ râm
balamon: bà la môn
trớc: trước
xatra: sa tra
chnăm: chờ năm
oóc: óc
boóc: bóc
dơng: dương
hiùnh: huỳnh
neang: nang
nuth: nút
panth: ban
pem: bem
nêang: nê ang
tk: thằng
mik: mình
mìk: mình
kh: không
ak: á
ch: chưa
cx: cũng
đc: được
kt: kiểm tra
bn: bạn
mn: mọi người
nt: nhắn tin
khoong: không
thjk: thì
mỏg: mỏng
khong: không
quâ: quá
mngf: mọi người
bt: biết
bj: bị
nma: nhưng mà
đk: điều kiện
ms: mới
vd: video
mng: mọi người
vs: với
ntn: như thế này
sp”: sản phẩm
kg: không
bth: bình thường
v: vậy
tl: trả lời
lm: làm
vơi: với
duocd: được
dđc: được
nx: nữa
r: rồi
mk: mình
j: gì
z: vậy
ns: nói
ae: anh em
hôg: không
cgi: cái gì
cs: có
nhma: nhưng mà
ntin: nhắn tin
trl: trả lời
hd: hướng dẫn
tgian: thời gian
tht: thật
ktra: kiểm tra
cug: cũng
sn: suy nghĩ
hing: hong
ht: hết
bic: biết
trloi: trả lời
nchung: nói chung
akk: à
chx: chưa
nhx: nhưng
tr: trời
sz: size
ng: người
đx: được
kpit: không biết
thik: thích
gquyet: giải quyết
kbiet: không biết
dth: dễ thương
cty: công ty
nnao: như nào
lun: luôn
stk: số tài khoản
cte: cute
xink: xinh
đt: điện thoại
ln: luôn
nv: như vậy
cskh: chăm sóc khách hàng
trg: trong
bcuoi: buồn cười
pk: phải
gg: giảm giá
sdt: số điện thoại
bh: bây giờ
dt: điện thoại
dg: đường
lămz: lắm
mh: mình
jiong: giống
ik: y
bngoai: bên ngoài
roii: rồi
sóp: cửa hàng
dell: đéo
ngieu: người yêu
from: dạng chữ
form: dạng chữ
o: ở
h: giờ
sv: sinh viên
sop: cửa hàng
lmj: làm gì
e: em
dc: được
l: làm
t: tao
s: sao
ngta: người ta
ib: nhắn tin riêng
lh: liên hệ
mak: mà
bùn: buồn
đv: được
hok: không
đb: đặc biệt
sl: số lượng
vx: vẫn
ksao: không sao
siu: siêu
í: ý
củm: cảm
mlem: ngon
thui: thôi
zl: vãi
iu: yêu
cp: cặp
hong: không
ă: á
sịn: xịn
rùi: rồi
oki: ổn
chùi ui: trời ơi
jztr: gì vậy trời
nhìu: nhiều
rấy: thấy
nxb: nhà xuất bản
alo: a lô
a: anh
sr: xin lỗi
đl: đà lạt
sg: sài gòn
ndung: nội dung
qtrinh: quá trình
sp: sản phẩm
chẳnh: chẳng
kn: kinh nghiệm
gấc nà: rất là
sh: cửa hàng
m: mình
hn: hà nội
hcm: hồ chí minh
tmdt: thương mại điện tử
tmđt: thương mại điện tử
qđndvn: quân đội nhân dân việt nam
vv: vân vân
combo: gói
font: kiểu chữ
seal: niêm phong
gđ: gia đình
shipper: người giao hàng
sale: giảm giá
vote: đánh giá
box: hộp
review: đánh giá
df: lỗi
gd: gia đình
chil: nhẹ nhàng
bg: bao giờ
zậy: vậy
omg: ôi chúa ơi
follow: theo dõi
nx: nữa
nhuma: nhưng mà
vch: vận chuyển
ebook: sách điện tử
nylon: ni lông
trend: xu hướng
cmnr: con mẹ nó rồi
sgk: sách giáo khoa
nhak: nha
nilon: ni lông
recommend: đề xuất
eng: tiếng anh
english: tiếng anh
good: tốt
sx: sản xuất
okela: ổn
oke: ổn
gùi: rồi
catton: cạc tông
fom: hình dạng
tuỵt: tuyệt
rv: đánh giá
ghtk: giao hàng tiết kiệm
giame: giảm
taajp5: tập
htrc: hôm trước
hsau: hôm sau
edition: phiên bản
dark: đen tối
nilong: ni lông
voucher: phiếu
ohair: phải
cuoon: cuốn
box: hộp
cmt: bình luận
postcard: thẻ bo góc
order: đặt hàng
ship: giao hàng
shiper: người giao hàng
fan: người hâm mộ
boxset: bộ hộp
chacw: chắc
uk: anh
us: mỹ
quiz: câu đố
đc: được
nylon: ni lông
nk: nhật ký
slogan: khẩu hiệu
chat: nhắn tin
gê: ghê
check: kiểm tra
trê tay: trên tay
iừa: lừa
bôkcare: bookcare
xâue: xấu
tùe: từ
ecom: thương mại điện tử
nhuwng: nhưng
rr: rồi
đucợ: được
khã: khác
feedback: phản hồi
mt: môi trường
rcm: đề xuất
khôg: không 
quyêtn: quyển
photo: sao chép
ncl: nói chung là
mlh: mai lan hương
yb: you tube
nhhix: nhìn
sd: sử dụng
vđề: vấn đề
hqua: hôm qua
xg: xong
nd: nội dung
nch: nói chung
onl: trực tuyến
dv: dịch vụ
tks: cảm ơn
nhm: nhưng mà
đh: đại học
nsx: nhà sản xuất
hdsd: hướng dẫn sử dụng
fen: bạn
ap: phần mềm
gấc: rất
gất: rất
bookmark: dấu trang
haig: hài
qtrong: quan trọng
riveiw: đánh giá
thichd: thích
sacgs: sách
recmd: để xuất
tgeer: thể
khog: không
10d: 10 điểm
tym: tim
hnay: hôm nay
unhr: ủng
obi: dây bọc
nna: nguyễn nhật ánh
size: cỡ
gê: ghê
ytb: youtube
btw: ngoài ra
vhvn: văn học việt nam
bonu: thêm
lms: Hệ quản trị đào tạo
yn: ý nghĩa
trobg: trong
tgia: tác giả
bv: bệnh viện
nhg: nhưng
vđ: vấn đề
đag: đang
vuêch: việc
oder: đặt hàng
cjo: cho
mqh: mối quan hệ
bk: biết
bbw: bao bì đệm
hịn: xịn
bthw: bình thường
chill: thư giãn
shop: cửa hàng
carton: cạc tông
%: phần trăm
qué: quá
trùi: trời
ui: ơi
đẽ: đã
